type octile
height 20
width 44
map
TTTTTTTTTTTTTTTTTTTTTTTTTTTTTTTTTTTTTTTTTTTT
T..........................................T
T..........................................T
T..........TTTTTTTTTT..TTTTTTTTTT..........T
T..........TTTTTTTTTT..TTTTTTTTTT..........T
T..........................................T
T..........................................T
T..........TTTTTTTTTT..TTTTTTTTTT..........T
T..........TTTTTTTTTT..TTTTTTTTTT..........T
T..........................................T
T..........................................T
T..........TTTTTTTTTT..TTTTTTTTTT..........T
T..........TTTTTTTTTT..TTTTTTTTTT..........T
T..........................................T
T..........................................T
T..........TTTTTTTTTT..TTTTTTTTTT..........T
T..........TTTTTTTTTT..TTTTTTTTTT..........T
T..........................................T
T..........................................T
TTTTTTTTTTTTTTTTTTTTTTTTTTTTTTTTTTTTTTTTTTTT
